#| | | | |^| | | |^| | | |^| | | |^| | | |10|^|
^|^|^|^| |^| |^| |^| |^| |^| |^| |^| |^|^|^|^|
^|^|^|^| |^| |^| |^| |^| |^| |^| |^| |^|^|^|^|
^|^|^|^| |^| |^| |^| |^| |^| |^| |^| |^|^|^|^|
^|^|^|^| |^| |^| |^| |^| |^| |^| |^| |^|^|^|^|
^|^|^|^| |^| |^| |^| |^| |^| |^| |^| |^|^|^|^|
^|^|^|^| |^| |^| |^| |^| |^| |^| |^| |^|^|^|^|
^|^|^|^| |^| |^| |^| |^| |^| |^| |^| |^|^|^|^|
^|^|^|^| |^| |^| |^| |^| |^| |^| |^| |^|^|^|^|
^|^|^|^| |^| |^| |^| |^| |^| |^| |^| |^|^|^|^|
^|^|^|^| |^| |^| |^| |^| |^| |^| |^| |^|^|^|^|
^|^|^|^| |^| |^| |^| |^| |^| |^| |^| |^|^|^|^|
^|^|^|^| |^| |^| |^| |^| |^| |^| |^| |^|^|^|^|
^|^|^|^| |^| |^| |^| |^| |^| |^| |^| |^|^|^|^|
^|^|^|^| |^| |^| |^| |^| |^| |^| |^| |^|^|^|^|
^|^|^|^| |^| |^| |^| |^| |^| |^| |^| |^|^|^|^|
^|^|^|^| |^| |^| |^| |^| |^| |^| |^| |^|^|^|^|
^|^|^|^| |^| |^| |^| |^| |^| |^| |^| |^|^|^|^|
^|^|^|^| | | |^| | | |^| | | |^| | | |^|^|^|^|
^|^|^|^|^|^|^|^|^|^|^|^|^|^|^|^|^|^|^|^|^|^|^|
