#| |^|^|^|^|^|^|^|^|^|^|^|^|^|^|^|^|^|^|^|^|^|
^| | | | | | | | | | | | | | | | | | | | | |^|
^| | | | | | | | | | | | | | | | | | | | | |^|
^| | | | | | | | | | | | | | | | | | | | | |^|
^| | | | | | | | | | | | | | | | | | | | | |^|
^| | | | | | | | | | | | | | | | | | | | | |^|
^| | | | | | | | | | | | | | | | | | | | | |^|
^| | | | | | | | | | | | | | | | | | | | | |^|
^| | | | | | | | | | | | | | | | | | | | | |^|
^| | | | | | | | | | | | | | | | | | | | | |^|
^| | | | | | | | | | | | | | | | | | | | | |^|
^| | | | | | | | | | | | | | | | | | | | | |^|
^| | | | | | | | | | | | | | | | | | | | | |^|
^| | | | | | | | | | | | | | | | | | | | | |^|
^| | | | | | | | | | | | | | | | | | | | | |^|
^| | | | | | | | | | | | | | | | | | | | | |^|
^| | | | | | | | | | | | | | | | | | | | | |^|
^| | | | | | | | | | | | | | | | | | | | | |^|
^| | | | | | | | | | | | | | | | | | | | |10|^|
^|^|^|^|^|^|^|^|^|^|^|^|^|^|^|^|^|^|^|^|^|^|^|
