#| |^|^|^|^|^|^|^|^|^|^|^|^|^|^|^|^|^|^|^|^|^|
^| | | | | | | | | | | | | | | | | | | | | |^|
^| | | | | | | | | | | | | | | | | | | | | |^|
^| | | | | | | | | | | | | | | | | | | | | |^|
^| | | | | | | | | | | | | | | | | | | | | |^|
^| | | | | | | | | | | | | | | | | | | | | |^|
^| | | | |^| |^| | | | | | | | | | | | | | |^|
^| | | | |^|^|^| | | | | | | | | | | | | | |^|
^| | | | |^| |^| | | | | | | | | | | | | | |^|
^| | | | | | | | | | | | | | | | | | | | | |^|
^| | | | | | | | | | | | | | | | | | | | | |^|
^| | | | | | | | | | | | | | | | | | | | | |^|
^| | | | | | | | | | | | | | | | | | | | | |^|
^| | | | | | | | | | | | | | | | | | | | | |^|
^| | | | | | | | | | | | | | | | | | | | | |^|
^| | | | | | | | | | | | | | | | | | | | | |^|
^| | | | | | | | | | | | | | | | | | | | | |^|
^| | | | | | | | | | | | | | | | | | | | | |^|
^| | | | | | | | | | | | | | | | | | | | |10|^|
^|^|^|^|^|^|^|^|^|^|^|^|^|^|^|^|^|^|^|^|^|^|^|
