#| |^|^|^|^|^|^|^|^|^|^|^|^|^|^|^|^|^|^|^|^|^|
^| | | | | | | | | | | | | | | | | | | | | |^|
^| | | | | | | | | | | | | | | | | | | | | |^|
^| | | | | | | | | | | | | | | | | | | | | |^|
^| | | | | | | | | | | | | | | | | | | | | |^|
^| | | | | | | | | | | | | | | | | | | | | |^|
^| | | | | | |^|^|^|^|^|^|^| | | | | | | | |^|
^| | | | | | | | | |^| | | | | | | | | | | |^|
^| | | | | | | | | |^| | | | | | | | | | | |^|
^| | | | | | | | | |^| | | | | | | | | | | |^|
^| | | | | | |^|^|^|^|^|^|^| | | | | | | | |^|
^| | | | | | | | | | | | | | | | | | | | | |^|
^| | | | | | | | | | | | | | | | | | | | | |^|
^| | | | | | | | | | | | | | | | | | | | | |^|
^| | | | | | | | | | | | | | | | | | | | | |^|
^| | | | | | | | | | | | | | | | | | | | | |^|
^| | | | | | | | | | | | | | | | | | | | | |^|
^| | | | | | | | | | | | | | | | | | | | | |^|
^| | | | | | | | | | | | | | | | | | | | |10|^|
^|^|^|^|^|^|^|^|^|^|^|^|^|^|^|^|^|^|^|^|^|^|^|
