#| |^|^|^|^|^|^|^|^|^|^|^|^|^|^|^|^|^|^|^|^|^|
^| | | | | | | | | | | | | | | | | | | | | |^|
^| | | | | | | | | | | | | | | | | | | | | |^|
^| | | | | | | | | | | | | | | | | | | | | |^|
^| | | | | | | | | | | | | | | | | | | | | |^|
^| | | | | | | | | | | | | | | | | | | | | |^|
^| | | | | | | | | | | | | | | | | | | | | |^|
^| | | | | | |^|^| | | | |^|^| | | | | | | |^|
^| | | | | | |^| |^| | |^| |^| | | | | | | |^|
^| | | | | | |^| | |^|^| | |^| | | | | | | |^|
^| | | | | | |^| | | | | | |^| | | | | | | |^|
^| | | | | | | | | | | | | | | | | | | | | |^|
^| | | | | | | | | | | | | | | | | | | | | |^|
^| | | | | | | | | | | | | | | | | | | | | |^|
^| | | | | | | | | | | | | | | | | | | | | |^|
^| | | | | | | | | | | | | | | | | | | | | |^|
^| | | | | | | | | | | | | | | | | | | | | |^|
^| | | | | | | | | | | | | | | | | | | | | |^|
^| | | | | | | | | | | | | | | | | | | | |10|^|
^|^|^|^|^|^|^|^|^|^|^|^|^|^|^|^|^|^|^|^|^|^|^|