#| | | |^| |^| |^|^|^| |^|^|^| | | | | | | |^|
 |^|^| | | |^| | | | | | | | | | | | | | | |^|
 | |^| |^|^| | |^|^| |^| |^| | | | | | | | |^|
 |^| | | | | |^|^|^| |^| |^| | | | | | | | |^|
 | |^|^|^|^| |^|^| |^| | | |^| | | | | | | |^|
^| | | |^|^| | |^| |^|^|^| | | | | | | | | |^|
^| |^| |^|^|^|^| | | | | |^|^| | | | | | | |^|
^| |^| |^| | | | |^|^|^| |^| | | | | | | | |^|
 | | |^|^| |^|^| |^| | | |^| | | | | | | | |^|
^| |^|^| | | | | |^| |^|^|^| | | | | | | | |^|
^| | | |^|^|^|^| |^| | | | |^| | | | | | | |^|
^|^|^| |^| | | | |^|^|^| | | | | | | | | | |^|
^| | | |^| |^|^|^|^|^|^| | |^| | | | | | | |^|
^| |^|^|^| |^| | | | | | | | | | | | | | | |^|
^| | | | | |^|^|^| |^|^|^|^| |10|^|^|^|^|^| |^|
^| | |^|^|^|^|^|^|^|^|^|^|^|^|^|^|^|^|^| | |^|
^| |^|^|^|^|^|^|^|^| |^|^|^|^|^|^|^|^|^|^| |^|
^| |^| | | | | | | | | | | | | | | | | |^| |^|
^| | | | | | | | | | | | | | | | | | | | | |^|
^|^|^|^|^|^|^|^|^|^|^|^|^|^|^|^|^|^|^|^|^|^|^|
