#| |^|^|^|^|^|^|^|^|^|^|^|^|^|^|^|^|^|^|^|^|^|
^| | | | | | |^| |^|^| |^| | |#|#|^|^|^|^|^|^|
^| |^|^| |^| | | |^| | | | |^|^|#|#|#|#|#|^|^|
^| | | |^|^|^|^| | | |^|^|^|^|^|^|^|^|^|#|^|^|
^| | |^| | | | | |^|^|^| | |^|^|^|^|^|^|#|^|^|
^|^| |^|^|^|^| |^|^| | | |^|^|^|^|^|^|#|#|^|^|
^| | |^|^|^| | | | |^|^|^|^|^|^|^|^|^|#|^|^|^|
^|^| | | |^|^| |^| |^|^| | |^|^|^|^|^|#|^|^|^|
^|^|^| |^| | | |^| | | |^|^|^|^|^|^|^|#|^|^|^|
^|^|^| | |^|^|^|^| |^|^|^|^|^|^|^|^|^|#|#|^|^|
^|^|^| |^|^| |^| | |^|^| | |^|^|^|^|^|^|#|^|^|
^| | | |^| | |^| |^|^| | |^|^|^|^|^|^|^|#|^|^|
^| |^|^| | |^| | | | | |^| | |10|#|#|^|^|#|^|^|
^| |^|^|^| |^|^| |^|^| |^| |^|^|^|#|#|#|#|^|^|
^| | | | | |^|^| | | | | | |#|^|^|^|^|#|#|^|^|
^|#|#|^|^|^|^|^|^|^|#|^|^|^|^|^|^|^|^|^|#|#|^|
^|#|^|^|^|^|^|^|^|^|#|^|^|^|^|^|^|^|^|^|^|#|^|
^|#|^|#|#|#|#|#|#|#|#|#|#|#|#|#|#|#|#|#|^|#|^|
^|#|#|#|#|#|#|#|#|#|#|#|#|#|#|#|#|#|#|#|#|#|^|
^|^|^|^|^|^|^|^|^|^|^|^|^|^|^|^|^|^|^|^|^|^|^|
