#| | | | | | | | | | | | | | | | | | | |^|10|^|
^|^|^|^|^|^|^|^|^|^|^|^|^|^|^|^|^|^|^| |^| |^|
^| | | | | | | | | | | | | | | | | | | |^| |^|
^| |^|^|^|^|^|^|^|^|^|^|^|^|^|^|^|^|^|^|^| |^|
^| | | | | | | | | | | | | | | | | | | |^| |^|
^|^|^|^|^|^|^|^|^|^|^|^|^|^|^|^|^|^|^| |^| |^|
^| | | | | | | | | | | | | | | | | | | |^| |^|
^| |^|^|^|^|^|^|^|^|^|^|^|^|^|^|^|^|^|^|^| |^|
^| | | | | | | | | | | | | | | | | | | |^| |^|
^|^|^|^|^|^|^|^|^|^|^|^|^|^|^|^|^|^|^| |^| |^|
^| | | | | | | | | | | | | | | | | | | |^| |^|
^| |^|^|^|^|^|^|^|^|^|^|^|^|^|^|^|^|^|^|^| |^|
^| | | | | | | | | | | | | | | | | | | |^| |^|
^|^|^|^|^|^|^|^|^|^|^|^|^|^|^|^|^|^|^| |^| |^|
^| | | | | | | | | | | | | | | | | | | |^| |^|
^| |^|^|^|^|^|^|^|^|^|^|^|^|^|^|^|^|^|^|^| |^|
^| | | | | | | | | | | | | | | | | | | |^| |^|
^|^|^|^|^|^|^|^|^|^|^|^|^|^|^|^|^|^|^| |^| |^|
^| | | | | | | | | | | | | | | | | | | | | |^|
^|^|^|^|^|^|^|^|^|^|^|^|^|^|^|^|^|^|^|^|^|^|^|
