#| | |^|^|^| | | |^| | | |^|^|^|^|^|^|^|^|10|^|
^|^| | | |^| |^| |^|^|^| |^|^|^|^|^|^|^|^| |^|
^|^|^|^| |^| |^| |^| | | |^| | | | | | | | |^|
^| | | | |^| |^| |^| |^|^|^| |^|^|^|^|^|^|^|^|
^| |^|^|^|^| |^| |^| | | |^| | | | |^|^|^|^|^|
^| | | | |^| |^| |^|^|^| |^|^|^|^| | | | | |^|
^|^|^|^| |^| |^| |^| | | | | |^|^|^|^|^|^| |^|
^| | | | |^| |^| |^| |^|^|^| |^| | | | | | |^|
^| |^|^|^|^| |^| |^| | | |^| |^| |^|^|^|^|^|^|
^| | | | |^| |^| |^|^|^| |^| |^| | | |^|^|^|^|
^|^|^|^| |^| |^| |^| | | |^| |^|^|^| |^|^|^|^|
^| | | | |^| |^| |^| |^|^|^| |^|^|^| | | | |^|
^| |^|^|^|^| |^| |^| | | |^| |^|^|^|^|^|^| |^|
^| | | | |^| |^| |^|^|^| |^| | | |^|^| | | |^|
^|^|^|^| |^| |^| |^| | | |^|^|^| |^|^| |^|^|^|
^| | | | |^| |^| |^| |^|^|^| | | |^|^| | |^|^|
^| |^|^|^|^| |^| |^| | | |^| |^|^|^|^|^| |^|^|
^| |^|^|^|^| |^| |^|^|^| |^| | | |^|^| | |^|^|
^| | | | | | |^| | | | | |^|^|^| | | | |^|^|^|
^|^|^|^|^|^|^|^|^|^|^|^|^|^|^|^|^|^|^|^|^|^|^|
