#| | |^|^|^|^|^|^|^|^|^|^|^|^|^|^|^|^|^| | |10|^|
^|^| |^|^|^| |^|^|^|^|^|^|^|^|^|^| | | | |^|^|^|
^|^| | | | | |^|^|^| |^|^| |^|^|^| |^| |^|^|^|^|
^|^| | |^|^| | |^|^|^|^|^| |^|^|^| |^|^| |^|^|^|
^|^|^| |^|^|^| |^| |^|^|^| | | | | | | | |^|^|^|
^|^|^|^|^| | | |^|^| |^|^| |^|^|^|^|^| |^|^|^|^|
^| | |^|^| |^|^|^|^|^|^|^| |^| |^|^| | |^|^|^|^|
^| | | | | |^|^|^|^| | | | | | |^| | | | |^|^|^|
^| |^| |^| | | |^|^|^|^|^|^|^|^|^|^|^| | |^|^|^|
^| | | |^|^|^| | | |^|^|^|^| |^| |^| | | | |^|^|
^| |^|^|^| |^| |^| | | | |^| | | |^|^|^| |^|^|^|
^| | |^|^|^| | |^|^|^| |^|^|^| |^|^| |^| |^|^|^|
^|^| | | |^|^| | |^|^|^|^| | | |^|^|^|^| | |^|^|
^|^|^| |^|^| | | | | |^|^| |^| | | |^|^|^| |^|^|
^|^|^|^|^|^|^|^|^| | |^|^| |^| |^| |^| |^| |^|^|
^|^|^|^|^|^|^|^|^| |^|^| | |^| |^| |^|^|^| |^|^|
^| | |^| | | | | | | |^| |^|^| |^| |^| |^| |^|^|
^|^| | | |^| |^|^| | |^|^|^| | |^| |^|^|^| |^|^|
^|^| |^| |^| |^|^|^| | | | | |^|^| | | | | |^|^|
^|^|^|^|^|^|^|^|^|^|^|^|^|^|^|^|^|^|^|^|^|^|^|^|
