#| |^|^|^|^|^|^|^|^|^|^|^|^|^|^|^|^|^|^|^|^|^|
^| |^| | | | |^| |^|^| |^| | |#|#|^|^|^|^|^|^|
^| |^|^| |^| | | |^| | | | |_|^|^|#|#|#|#|#|^|
^| | | |^|^|^|^| | | |^|^|^|^|^|^|^|^|^|#|^|^|
^| | |^| | | | | |^|^|^| | |^|^|^|^|^|^|#|^|^|
^|^| |^|^|^|^| |^|^| | | |^|^|^|^|^|^|#|#|^|^|
^| | |^|^|^| | | | |^|^|^|^|^|^|^|^|^|#|^|^|^|
^|^| | | |^|^| |^| |^|^| | |^|^|^|^|^|#|^|^|^|
^|^|^| |^| | | |^| | | |^|^|^|^|^|^|^|#|^|^|^|
^|^|^| | |^|^|^|^| |^|^|^|^|^|^|^|^|^|#|#|^|^|
^|^|^| |^|^| |^| | |^|^| | |^|^|^|^|^|^|#|^|^|
^| | | |^| | |^| |^|^| | |^|^|^|^|^|^|^|#|^|^|
^| |^|^| | |^| | | | | |^| | | |#|#|^|^|#|^|^|
^| |^|^|^| |^|^| |^|^| |^| |^|^|^|#|#|^|#|^|^|
^| | | | | |^|^| | | | | | |#|^|^|^|#|#|#|^|^|
^|#|#|^|^|^|^|^|^|^|#|^|^|^|^|^|^|^|^|^|#|#|^|
^|#|^|^|^|^|^|^|^|^|#|^|^|^|^|^|^|^|^|^|^|#|^|
^|#|^|#|#|#|#|#|#|#|#|#|#|#|#|#|#|#|#|#|^|#|^|
^|#|#|#|#|#|#|#|#|#|#|#|#|#|#|#|#|#|#|#|#|#|^|
^|^|^|^|^|^|^|^|^|^|^|^|^|^|^|^|^|^|^|^|^|^|^|
